----OO---
--OO--OO-
XO--OO--O
--OO--OO-
-O--OO--O
--OO--OO-
----OO---
